28 28 28 28 28 28 28 28 28 28 28 246 0 60 214 213 704 705 706 707 708 298 299 211 152 152 152 152 152 152 152 281 282 283 284 285 81 412 379 148 86 0 239 240 412 423 379 175 176 0 
28 28 28 28 28 28 28 28 28 28 28 246 0 60 236 0 725 726 727 728 729 296 297 233 0 0 584 584 167 0 0 302 303 304 305 306 81 412 379 149 86 0 203 204 412 423 379 196 197 0 
28 28 28 28 28 28 28 28 28 28 28 246 0 60 236 0 746 747 748 749 750 0 0 233 296 297 167 276 0 0 0 322 324 325 326 327 81 412 379 151 86 0 156 158 412 423 379 161 162 0 
28 28 28 28 28 28 28 28 28 28 28 246 0 60 236 167 0 258 0 152 152 0 0 233 584 584 0 0 0 277 275 217 218 219 218 221 81 412 379 150 86 0 177 178 412 423 379 180 181 0 
28 28 28 28 28 28 28 28 28 28 28 246 0 60 236 0 0 368 601 346 0 0 0 233 317 318 0 278 0 0 0 239 242 241 242 243 81 83 84 147 86 0 198 199 412 423 379 200 202 0 
28 28 28 28 28 28 28 28 28 28 28 246 0 60 236 0 0 412 423 379 0 0 0 256 540 541 129 0 519 520 0 260 261 262 263 264 102 104 105 106 107 0 154 155 412 423 379 156 158 0 
28 28 28 28 28 28 28 28 28 28 28 246 0 60 236 0 167 579 423 590 612 601 601 612 612 601 612 612 612 612 612 612 601 601 612 612 612 612 612 86 0 0 175 176 412 423 379 177 178 0 
28 28 28 28 28 28 28 28 28 28 28 246 0 60 254 255 256 579 168 190 190 190 190 179 179 179 190 190 179 179 190 190 190 190 190 190 190 190 190 86 0 0 196 197 412 423 379 198 199 0 
28 28 28 28 28 28 28 28 28 28 28 246 0 102 103 103 103 83 84 106 106 106 106 106 106 106 106 106 106 106 106 106 106 106 106 106 106 106 106 107 0 0 161 162 412 423 379 154 155 0 
28 28 28 28 28 28 28 28 28 28 28 246 0 0 0 0 214 104 105 0 0 0 0 0 500 502 0 0 0 0 0 0 0 0 0 0 0 0 0 0 0 0 182 183 412 423 379 175 176 0 
28 28 28 28 28 28 28 28 28 28 28 246 0 149 0 0 233 368 346 0 195 195 0 584 521 522 519 520 0 152 152 0 13 24 24 24 24 24 24 35 0 0 203 204 412 423 379 196 197 0 
28 28 28 28 28 28 28 28 28 28 28 246 0 0 165 166 233 412 590 601 601 601 601 601 601 601 601 601 601 346 0 0 224 7 7 7 7 7 7 246 0 0 159 160 412 423 379 156 158 0 
28 28 28 28 28 28 28 28 28 28 28 246 280 280 280 280 233 412 423 423 423 423 423 423 423 423 423 423 423 557 152 0 224 7 7 7 7 7 7 246 0 0 180 181 412 423 379 177 178 0 
28 28 28 28 28 28 28 28 28 28 28 246 0 0 0 0 233 412 423 423 423 423 423 423 423 423 423 423 423 557 152 0 434 446 446 446 446 446 446 457 0 0 200 202 412 423 379 198 199 0 
28 28 28 28 28 28 28 28 28 28 28 246 0 0 0 0 233 412 423 423 423 423 423 423 423 423 423 423 423 590 601 601 601 601 601 601 601 601 601 601 601 601 601 601 623 423 590 601 601 601 
446 446 446 446 446 446 446 446 446 446 446 457 0 0 0 0 233 412 423 423 423 423 423 423 423 423 423 423 423 423 423 423 423 423 423 423 423 423 423 423 423 423 423 423 423 423 423 423 423 423 
281 282 283 284 285 286 287 288 289 291 217 218 219 220 221 0 233 412 423 168 179 179 179 179 179 179 179 179 179 179 179 179 179 201 423 423 168 190 190 190 190 179 179 179 201 423 168 190 190 190 
302 303 304 305 305 307 308 309 310 311 239 240 241 242 243 0 233 412 423 379 0 150 0 0 0 0 0 0 0 0 188 0 129 412 423 423 379 0 0 0 0 0 0 0 412 423 557 217 162 0 
322 324 325 326 327 328 329 330 331 332 260 261 262 263 264 0 233 412 423 379 0 587 588 589 591 592 0 593 594 595 596 597 0 412 423 423 379 0 424 425 426 427 428 167 412 423 557 239 181 0 
217 218 219 220 221 222 225 226 225 228 281 282 283 284 285 0 233 412 423 379 0 608 609 610 611 613 0 614 615 616 617 618 167 579 423 423 379 167 444 447 448 449 450 0 412 423 557 200 202 0 
239 240 241 242 240 244 245 247 248 249 302 303 304 305 306 0 233 412 423 379 0 629 630 631 632 633 0 635 636 637 632 639 0 579 423 423 379 0 466 467 469 470 471 0 412 423 557 156 158 0 
260 261 262 263 264 265 266 267 269 270 322 324 325 326 327 0 233 412 423 379 0 650 651 652 653 654 0 655 657 658 659 660 0 579 423 423 379 0 487 488 489 491 492 167 412 423 557 177 178 0 
213 213 213 213 213 213 213 213 213 213 213 213 213 213 213 213 172 412 423 379 0 0 0 0 0 296 297 0 0 0 0 0 188 579 423 423 379 0 0 238 0 152 152 0 412 423 557 198 199 0 
0 0 0 0 0 0 0 0 0 0 0 0 0 0 0 280 280 412 423 379 147 0 0 0 237 280 0 0 259 0 153 174 0 579 423 423 379 167 0 0 0 0 0 0 412 423 557 154 155 0 
594 595 596 597 731 770 771 686 0 0 0 429 433 435 0 0 280 412 423 590 601 601 601 601 601 601 601 601 601 601 601 601 601 623 423 423 590 612 612 612 612 612 612 612 623 423 557 175 176 0 
615 616 617 618 751 792 793 707 708 0 444 447 448 449 450 0 280 412 423 423 423 423 423 423 423 423 423 423 423 423 423 423 423 423 423 423 423 423 423 423 423 423 423 423 423 423 557 196 197 0 
636 637 638 639 0 813 727 728 729 0 466 467 469 470 471 0 280 412 423 423 423 423 423 423 423 423 423 423 423 423 423 423 423 423 423 423 423 423 423 423 423 423 423 423 423 423 590 612 601 612 
657 658 659 660 0 746 748 749 750 0 487 488 489 491 492 0 0 412 423 423 423 423 423 423 423 423 423 423 423 423 423 423 423 423 423 423 423 423 423 423 423 168 179 179 179 179 179 179 179 179 
297 423 259 0 0 277 423 259 0 0 298 299 423 238 0 0 0 579 423 423 423 423 423 423 423 423 423 423 423 423 423 423 423 423 423 423 423 423 423 423 423 379 0 214 213 429 430 431 213 214 
623 423 590 601 601 623 423 590 601 601 601 623 423 590 601 601 601 623 423 423 423 423 423 423 423 423 423 423 423 423 423 423 423 423 423 423 423 423 423 423 423 379 0 233 0 451 452 453 0 236 
423 423 423 423 423 423 423 423 423 423 423 423 423 423 423 423 423 423 423 423 423 423 423 423 83 84 423 423 423 423 423 423 423 423 423 423 423 423 423 423 423 379 0 233 0 472 473 474 0 236 
42 42 42 42 42 42 42 42 42 42 42 42 42 42 42 42 42 42 40 40 40 40 40 40 104 105 43 43 43 43 43 43 44 0 423 423 423 423 423 423 423 379 0 233 0 493 494 495 0 236 
0 0 0 0 0 0 0 0 0 0 0 0 0 0 0 0 71 72 0 0 0 0 0 0 0 0 0 0 0 0 0 0 86 0 423 423 423 423 423 423 423 379 0 233 0 368 601 346 0 236 
0 0 0 0 0 0 0 0 0 0 0 0 0 0 0 0 0 72 0 0 0 0 0 0 0 0 0 0 0 0 0 0 86 0 0 423 423 423 423 423 423 379 0 256 255 579 423 379 255 256 
0 0 0 0 0 0 0 0 0 0 0 0 0 0 0 0 0 0 0 0 0 0 0 0 0 0 0 0 0 0 0 0 86 0 0 0 423 423 423 423 423 590 601 601 601 623 423 379 237 0 
0 0 0 0 0 0 0 0 0 0 0 0 0 0 0 0 0 0 0 0 0 0 0 0 0 0 0 0 0 0 0 0 86 0 0 0 0 423 423 423 423 423 423 423 423 423 423 557 0 0 
152 152 152 152 152 152 152 0 72 72 0 0 0 0 0 0 0 0 0 0 0 0 0 0 0 0 0 0 0 0 0 0 86 0 0 0 71 71 68 68 68 179 179 179 179 179 179 135 298 299 
23 23 23 23 23 23 323 108 273 274 72 72 72 72 72 72 72 72 0 0 0 0 0 0 0 0 0 0 0 0 0 0 86 0 701 712 712 712 712 712 712 712 712 712 712 712 712 723 189 73 
28 28 28 28 28 28 853 189 294 295 72 72 72 72 72 72 72 72 0 0 0 0 0 0 0 0 0 0 0 0 0 0 86 0 15 16 16 16 16 16 16 16 16 16 16 16 16 849 210 335 
28 28 28 28 28 28 853 210 13 35 152 152 3 72 72 72 72 0 0 0 0 0 0 0 0 0 0 0 0 0 0 0 86 0 15 16 16 16 16 16 16 16 16 16 16 16 16 849 0 6 
28 28 28 28 28 28 21 25 27 21 24 35 152 152 3 72 72 0 0 49 49 49 49 49 0 0 0 49 49 49 3 0 86 0 15 16 16 16 16 16 16 16 16 16 16 16 16 849 0 6 
28 28 28 28 28 28 28 28 28 28 28 21 22 323 152 152 152 152 152 152 152 152 152 152 152 152 152 152 152 152 152 152 107 0 15 16 16 16 16 16 16 16 16 16 16 16 16 849 0 6 
28 28 28 28 28 28 28 28 28 28 28 28 28 21 22 23 23 23 23 23 23 23 23 23 23 23 23 23 23 23 23 23 323 0 15 16 16 16 16 16 16 16 16 16 16 16 16 849 0 6 
28 28 28 28 28 28 28 28 28 28 28 28 28 28 28 28 28 28 28 28 28 28 28 28 28 28 28 28 28 28 28 28 853 0 15 16 16 16 16 16 16 16 16 16 16 16 16 849 0 6 
28 28 28 28 28 28 28 28 28 28 28 28 28 28 28 28 28 28 28 28 28 28 28 28 28 28 28 28 28 28 28 28 853 0 15 16 16 16 16 16 16 16 16 16 16 16 16 849 0 6 
28 28 28 28 28 28 28 28 28 28 28 28 28 28 28 28 28 28 28 28 28 28 28 28 28 28 28 28 28 28 28 28 853 0 15 16 16 16 16 16 16 16 16 16 16 16 16 849 0 6 
28 28 28 28 28 28 28 28 28 28 28 28 28 28 28 28 28 28 28 28 28 28 28 28 28 28 28 28 28 28 28 28 853 0 15 16 16 16 16 16 16 16 16 16 16 16 16 849 0 6 
28 28 28 28 28 28 28 28 28 28 28 28 28 28 28 28 28 28 28 28 28 28 28 28 28 28 28 28 28 28 28 28 853 0 15 16 16 16 16 16 16 16 16 16 16 16 16 849 0 6 
28 28 28 28 28 28 28 28 28 28 28 28 28 28 28 28 28 28 28 28 28 28 28 28 28 28 28 28 28 28 28 28 21 23 36 37 37 37 37 37 37 37 37 37 37 37 37 38 22 27 
28 28 28 28 28 28 28 28 28 28 28 28 28 28 28 28 28 28 28 28 28 28 28 28 28 28 28 28 28 28 28 28 28 28 28 28 28 28 28 28 28 28 28 28 28 28 28 28 28 28 
